{
    "Width": 8,
    "Height": 6,
    "TileSize": 32,
    "Data" :[
        [0, 0, 0, 0, 0, 0, 0, 0],
        [1, 1, 1, 0, 1, 1, 1, 0],
        [0, 1, 0, 0, 1, 0, 1, 0],
        [1, 1, 1, 1, 1, 1, 1, 1],
        [1, 0, 1, 0, 1, 0, 1, 0],
        [1, 0, 1, 1, 1, 1, 1, 0]
    ]
}